15 15
0 0
0 0 0 1 0 7 0 0 1 0 0 0 0 1 0
1 1 3 3 1 7 0 3 0 0 1 1 3 3 1
0 1 1 0 0 7 0 2 0 0 0 1 1 0 0
0 0 1 2 0 7 1 2 0 0 0 0 1 2 0
5 4 1 4 2 7 0 0 1 0 5 4 1 4 2
6 6 6 6 6 8 6 6 6 6 6 6 6 6 6
3 3 1 3 3 7 1 2 2 0 3 3 1 3 3
2 2 1 2 2 7 0 0 0 0 2 2 1 2 2
0 0 5 5 4 7 0 5 0 0 0 0 5 5 4
3 3 1 3 3 7 0 0 1 0 3 3 1 3 3
0 0 0 1 0 7 0 0 1 0 0 0 0 1 0
1 1 3 3 1 7 0 3 0 0 1 1 3 3 1
0 1 1 0 0 7 0 2 0 0 0 1 1 0 0
0 0 1 2 0 7 1 2 0 0 0 0 1 2 0
5 4 1 4 2 7 0 0 1 0 5 4 1 4 2




